378

De Manila —- Manila. Dianensis - Diano.
De Nicaragua —- Nicaragua. Diniensis - Digne.
De Plata — La Plata. Δ Dionysiensis - Dionisia.
De Plata -— Chai-cas. Divionensis — Dijon.
¹ De Portorico — Portorico. Dromorensis -· Dromore. x
Derthonensis —- Tortona. · Duacensis - Kilmacduagh.
Derthusensis -- Tortosa. , Dublinensis - Dublino.
De Serena —- Serena. Dubuquensis — Dubuque.
De Tulacingo — Tulacingo. Dunensis -κ Down.
De Zacatecas - ZacatecaS. Dyrrachiensis - Durazzo.
Ε
Ebroieensis -- Evreux. Emesenus —- HomS.
Ecclesiensis -- Iglesias. Emiliensis — Emly. ι
Edessenus -.- Edessa. Engolismensis - Angouleme. ’
Egitto pei Gofti. ‘ Ephesinus r- Et‘eso,
E'gitto pei Latini. “ Eriensis —- Erie.
Eleutheropolitanus — Eleutero- Erithrensis - Eritrea.
poli. ' Erzegovina. ,
Elnensis - Pei-pignano. Erzerumiensis - Erzerum.
Elphinensis —- Elphin. Eugubinus — Gubbio.
Emeritensis -- Merida. Euriensis -— Euria.
„Emesenus — Emeso. Eystetensis — Eiohstfitt.
f.-
Fabrianensis - Fabi-iano. Florentinus — Firenze.
Faliscodunensis —- Monte-Fia- Flaviopolitanus -— Flaviopoli. ·
-scone Florida. , ’ ’
Fanensis — Fano. Fogarasiensis - Fogaras.
Feltrensis -,- Feltre. Fulginatensis -- Foligno.
Ferentinus — Ferentino. Foroliviensis — Forli. ,
Feretranus — Monte—Feltro. Fortalexiensis - Fortalezza.
Firmanus — Fermo. Fortalexiensis — Clara. ⁴
Fernensis —- Ferns. Forosemproniensis—Fossombrone. ᾖ,
Ferrariensis -- Ferrara. ForOJ‘nliensis — Frejus. ’
Filippopoli. Frisingensis -- *Frisingae
Finaborensis -- Kilfenora. Funchglensis - Funchal.·
G ,
Gallesinus -- Gallese. Galtellinensis Norensis -- G'altfflli ’

Gallipolitainus -- Gallipoli. Nuoro.

 

