386

Thyatirensis — -Tiatira.- Tolonensis - Tolone.
Tiberiadensis - Tiberiade. Δ Tolosanus - Tolosa.
Thinensis - Tine. Taurinensis —- Torino.
Tipasitanus — Tipasa. ’ Toronensis - Torone.
Tyrensis - Tiro (r. Mar.). Torontinus — Toront0.
Tyrensis — Tiro (r. Melo). Turoanensisl — Toscanella.
Tiburtinus - Τίνο11.- Tullensis — Toul.
Tlascalensis - Tlasoala. Tornaoensis — Tournay.
Tudertinus —- Todi. · Turonensis - Tours.
Tolentinus - Tolentino. Tonkino Orientale.
U
Urbevetanus -—- Orviet0. Urgellensis - Urgel.
Utinensis — Udine. Ultraieotensis - Utrecht. ’
Urbaniensis — Urbania. Ultraieotensis - Utreeht (gia).
Urbinatensis — Urbin0. Uxellensis — AleS.
- V

Vaciensis — aecia. Verulanus — Veroli.
Valacohia. ’ Veronensis — Verona.
Valentinensis — Valenee. . Versaliensis — VersailleS.
Valentinus — Valenza. Vesprimiensis — Veszprim.
Vallisoletanus — Valladolid. Vieentinus — Vioenza.
Vancouveriensis —— Vancouver. V'Qensis — Vich.
Vapineensis — Gap. Viennensis — Vienna.
Vallis Vidonis — Laval. verae-Crucis — Zalapa.
Vallispratensis — Marysville. Vestanus — Viesti. ,

· Venetensis — Vannes. Vincennapolitanus — Vincen-
Venetensis — Vannes (gia). nes,
Vastensis — Vasto. , Viterbiensis — ViterbO.
Veglensis —= Veglia. Victoriensis — Vittoria.
Veliternus - Velletri. Vivariensis - Viviers.
venetiarum - Venezia. Vizigapatan. .
Ventimiliensis —- Ventimiglia. Vigil‘iensis — Bisceglia.
Verae-Oruois —- Vera-Gruz. Victoriensis — Porto-Vittoria.
Verapoly. volaterranus —·- Volterra.
Verdunensis - Verdun. Vratislaviensis - Breslavia.

W -

·Warmiensis - Warmia. ν westmonasteriensis - West-

Wellingtoniensis - Welling- minster.
ton. Wheelingensis — Wheeling.

 

